[
["F", "F", "F", "F", "F", "F", "F", "F", "F", "F", "F", "F", "F", "F", "F", "F", "F", "M", "M", "M", "M", "M", "M", "M", "M", "M", "M", "M", "M", "F", "F", "F", "F", "F", "F", "F", "F", "F", "F", "F", "F", "F", "F", "F", "F", "W", "W", "W", "W", "W", "W"],
["F", "F", "F", "F", "F", "F", "F", "F", "F", "F", "F", "F", "F", "F", "F", "F", "F", "M", "M", "M", "M", "M", "M", "M", "M", "M", "M", "M", "M", "F", "F", "F", "F", "F", "F", "F", "F", "F", "F", "F", "F", "F", "F", "F", "W", "W", "W", "W", "F", "F", "F"],
["F", "F", "F", "F", "F", "F", "F", "F", "F", "F", "F", "F", "F", "F", "F", "F", "F", "F", "F", "M", "M", "M", "M", "M", "M", "M", "M", "M", "M", "F", "F", "F", "F", "F", "F", "F", "F", "F", "F", "F", "F", "F", "F", "F", "W", "W", "W", "F", "F", "F", "F"],
["F", "F", "F", "F", "F", "F", "F", "F", "G", "G", "G", "F", "F", "F", "F", "F", "F", "F", "F", "M", "M", "M", "M", "M", "M", "M", "M", "F", "F", "F", "F", "F", "F", "F", "F", "F", "F", "F", "F", "F", "F", "F", "F", "W", "W", "W", "F", "F", "F", "F", "F"],
["F", "F", "F", "F", "F", "F", "F", "G", "G", "G", "G", "G", "G", "F", "F", "F", "G", "G", "G", "M", "M", "M", "M", "M", "M", "G", "G", "G", "G", "F", "F", "W", "W", "W", "W", "W", "F", "W", "W", "W", "F", "W", "W", "W", "W", "F", "F", "F", "F", "F", "F"],
["F", "F", "F", "F", "F", "F", "F", "G", "G", "G", "G", "G", "G", "G", "G", "G", "G", "G", "M", "M", "M", "M", "M", "M", "G", "G", "G", "G", "G", "G", "W", "W", "W", "W", "W", "W", "W", "W", "W", "W", "W", "W", "W", "W", "W", "F", "F", "F", "F", "F", "F"],
["F", "F", "F", "F", "F", "F", "F", "G", "G", "G", "G", "G", "G", "G", "G", "G", "G", "G", "M", "M", "M", "M", "M", "G", "G", "G", "G", "G", "G", "G", "W", "W", "W", "W", "W", "W", "W", "W", "W", "W", "W", "W", "W", "W", "F", "F", "F", "F", "F", "F", "F"],
["F", "F", "F", "F", "F", "F", "F", "G", "G", "G", "G", "G", "G", "G", "G", "G", "G", "M", "M", "M", "M", "M", "M", "G", "G", "G", "G", "G", "G", "G", "G", "W", "W", "W", "W", "W", "W", "W", "W", "W", "W", "W", "W", "W", "F", "F", "F", "F", "F", "F", "F"],
["F", "F", "F", "F", "F", "G", "G", "G", "G", "G", "G", "G", "G", "G", "G", "G", "G", "M", "M", "M", "G", "G", "G", "G", "G", "G", "G", "G", "G", "G", "G", "W", "W", "W", "W", "W", "W", "W", "W", "W", "W", "W", "W", "F", "F", "F", "F", "F", "F", "F", "W"],
["F", "F", "F", "G", "G", "G", "G", "G", "G", "G", "G", "G", "G", "G", "G", "G", "G", "M", "M", "M", "G", "G", "G", "G", "G", "G", "G", "G", "G", "G", "G", "W", "W", "W", "W", "W", "W", "W", "W", "W", "W", "W", "W", "W", "F", "F", "F", "F", "F", "W", "W"],
["F", "F", "G", "G", "G", "G", "G", "G", "G", "G", "G", "G", "G", "G", "G", "G", "G", "G", "G", "G", "G", "G", "G", "G", "G", "G", "G", "G", "G", "G", "G", "W", "W", "W", "W", "W", "W", "W", "W", "W", "W", "W", "W", "W", "W", "F", "F", "F", "F", "W", "F"],
["F", "G", "G", "G", "G", "G", "G", "G", "G", "G", "G", "G", "G", "G", "G", "G", "G", "G", "G", "G", "G", "G", "G", "G", "G", "G", "G", "G", "G", "G", "G", "W", "W", "W", "W", "W", "W", "W", "W", "W", "W", "W", "W", "W", "W", "W", "F", "F", "W", "W", "F"],
["F", "G", "G", "G", "G", "G", "G", "G", "G", "G", "G", "G", "G", "G", "G", "G", "G", "G", "G", "G", "G", "G", "G", "G", "G", "G", "G", "G", "G", "G", "W", "W", "W", "W", "W", "W", "W", "W", "W", "W", "W", "W", "W", "W", "W", "W", "W", "W", "W", "G", "G"],
["G", "G", "G", "G", "G", "G", "G", "G", "G", "G", "G", "G", "G", "G", "M", "M", "M", "G", "G", "G", "G", "G", "G", "G", "G", "G", "G", "G", "G", "G", "W", "W", "W", "W", "W", "W", "W", "W", "W", "W", "W", "W", "W", "W", "F", "G", "G", "G", "G", "G", "G"],
["G", "G", "G", "G", "G", "G", "G", "G", "G", "G", "G", "G", "G", "G", "M", "M", "M", "M", "M", "M", "M", "G", "G", "G", "G", "G", "G", "G", "G", "W", "W", "W", "W", "W", "W", "W", "W", "W", "W", "W", "W", "W", "W", "F", "F", "G", "G", "G", "G", "G", "G"],
["G", "G", "G", "G", "G", "G", "G", "G", "G", "G", "G", "M", "M", "M", "M", "M", "M", "M", "M", "M", "M", "G", "G", "G", "G", "G", "G", "W", "W", "W", "W", "W", "W", "W", "F", "W", "W", "W", "W", "F", "F", "F", "F", "F", "F", "F", "G", "G", "G", "G", "G"],
["G", "G", "G", "G", "G", "G", "G", "G", "G", "G", "G", "M", "M", "M", "M", "M", "M", "M", "M", "M", "M", "M", "M", "G", "G", "G", "G", "W", "W", "W", "W", "W", "W", "F", "F", "F", "F", "F", "F", "F", "F", "F", "F", "F", "F", "F", "F", "F", "G", "G", "G"],
["G", "G", "G", "G", "G", "G", "G", "G", "G", "G", "G", "M", "M", "M", "M", "M", "M", "M", "M", "M", "M", "M", "M", "G", "G", "G", "G", "G", "W", "W", "W", "W", "F", "F", "F", "F", "F", "F", "F", "F", "F", "F", "F", "F", "F", "F", "F", "G", "G", "G", "G"],
["G", "G", "G", "G", "G", "G", "G", "G", "G", "G", "G", "M", "M", "M", "G", "M", "M", "M", "M", "M", "M", "M", "M", "G", "G", "G", "G", "G", "G", "F", "F", "F", "F", "F", "F", "F", "G", "G", "G", "G", "G", "F", "F", "F", "F", "G", "G", "G", "G", "G", "G"],
["G", "G", "G", "G", "G", "G", "G", "G", "G", "G", "G", "G", "G", "G", "G", "G", "G", "G", "G", "G", "G", "G", "G", "G", "G", "G", "G", "G", "G", "G", "G", "G", "G", "G", "G", "G", "G", "G", "G", "G", "G", "G", "G", "F", "F", "G", "G", "G", "G", "G", "G"],
["G", "G", "G", "G", "G", "G", "G", "G", "G", "G", "G", "G", "G", "G", "G", "G", "G", "G", "G", "G", "G", "G", "G", "G", "G", "G", "G", "G", "G", "G", "G", "G", "G", "G", "G", "G", "G", "G", "G", "G", "G", "G", "G", "G", "F", "G", "G", "G", "G", "G", "G"],
["G", "G", "G", "G", "G", "G", "G", "G", "G", "G", "G", "G", "G", "G", "G", "G", "G", "G", "G", "G", "G", "G", "G", "G", "G", "G", "G", "G", "G", "G", "G", "G", "G", "G", "G", "G", "G", "G", "G", "G", "G", "G", "G", "G", "G", "G", "G", "G", "G", "G", "F"],
["G", "G", "G", "G", "G", "G", "G", "G", "G", "G", "G", "G", "G", "G", "G", "W", "G", "W", "W", "W", "W", "G", "G", "G", "G", "G", "G", "G", "G", "G", "G", "G", "G", "G", "G", "G", "G", "G", "G", "G", "G", "G", "G", "G", "G", "F", "G", "G", "G", "G", "F"],
["G", "G", "G", "G", "G", "G", "G", "G", "G", "G", "G", "G", "F", "F", "F", "W", "W", "W", "W", "W", "W", "G", "G", "G", "G", "G", "G", "G", "G", "G", "G", "G", "G", "G", "G", "G", "G", "G", "G", "G", "G", "G", "G", "G", "G", "F", "G", "G", "G", "G", "F"],
["F", "G", "G", "G", "G", "G", "G", "G", "G", "G", "G", "G", "F", "F", "W", "W", "W", "W", "W", "W", "G", "G", "G", "G", "G", "G", "G", "G", "G", "G", "G", "G", "G", "G", "G", "G", "G", "G", "G", "G", "G", "G", "G", "G", "G", "F", "G", "G", "G", "F", "F"],
["F", "F", "F", "G", "G", "G", "G", "G", "G", "G", "G", "G", "F", "F", "W", "W", "W", "W", "W", "G", "G", "G", "G", "G", "G", "V", "G", "G", "G", "G", "G", "G", "G", "G", "G", "G", "G", "G", "G", "G", "G", "G", "G", "G", "G", "G", "G", "G", "F", "F", "F"],
["F", "F", "F", "F", "F", "G", "G", "G", "G", "G", "G", "F", "F", "F", "W", "W", "W", "W", "F", "G", "G", "G", "G", "G", "G", "G", "G", "G", "G", "G", "G", "G", "G", "G", "G", "G", "G", "G", "G", "G", "G", "G", "G", "G", "G", "G", "G", "G", "F", "F", "F"],
["F", "F", "F", "F", "F", "G", "G", "G", "G", "G", "G", "F", "F", "F", "F", "F", "W", "F", "F", "G", "G", "G", "G", "G", "G", "G", "G", "G", "G", "G", "G", "G", "G", "G", "G", "G", "G", "G", "G", "G", "G", "G", "G", "G", "G", "G", "G", "G", "F", "F", "F"],
["F", "F", "F", "F", "F", "G", "G", "G", "G", "G", "F", "F", "F", "F", "F", "W", "W", "F", "F", "F", "G", "G", "G", "G", "G", "G", "G", "G", "M", "M", "M", "M", "G", "G", "G", "G", "G", "G", "G", "G", "G", "G", "G", "G", "G", "G", "G", "G", "F", "F", "F"],
["F", "F", "F", "F", "F", "F", "G", "G", "G", "F", "F", "F", "F", "F", "W", "W", "F", "F", "F", "F", "F", "F", "G", "G", "G", "M", "M", "M", "M", "M", "M", "M", "G", "G", "G", "G", "G", "G", "G", "G", "G", "G", "G", "G", "G", "G", "G", "G", "F", "F", "F"],
["F", "F", "F", "F", "F", "F", "F", "F", "F", "F", "F", "F", "F", "F", "W", "W", "F", "F", "F", "F", "F", "F", "F", "F", "F", "M", "M", "M", "M", "M", "M", "M", "G", "G", "G", "G", "G", "G", "G", "G", "G", "G", "G", "G", "G", "G", "G", "G", "F", "F", "F"],
["F", "F", "F", "F", "F", "F", "F", "F", "F", "F", "F", "W", "W", "W", "W", "F", "F", "F", "F", "F", "F", "F", "F", "F", "F", "M", "M", "M", "M", "M", "G", "G", "G", "G", "G", "G", "G", "G", "G", "G", "G", "G", "G", "G", "G", "G", "G", "G", "F", "F", "F"],
["F", "F", "F", "F", "F", "F", "F", "F", "F", "F", "W", "W", "F", "F", "W", "F", "F", "F", "F", "W", "W", "W", "W", "W", "W", "M", "M", "M", "G", "G", "G", "G", "G", "G", "G", "G", "G", "G", "G", "G", "G", "G", "G", "G", "G", "G", "G", "G", "F", "F", "F"],
["F", "F", "F", "F", "F", "F", "F", "F", "F", "F", "W", "F", "F", "F", "W", "F", "F", "W", "W", "W", "W", "W", "W", "W", "W", "W", "W", "W", "G", "G", "G", "G", "G", "G", "G", "G", "G", "G", "G", "G", "G", "G", "G", "G", "G", "G", "G", "F", "F", "F", "F"],
["F", "F", "F", "F", "F", "F", "F", "F", "W", "W", "W", "W", "F", "F", "W", "W", "W", "W", "W", "W", "W", "W", "W", "W", "W", "W", "W", "W", "W", "G", "G", "G", "G", "G", "G", "G", "G", "G", "G", "G", "G", "G", "G", "G", "G", "G", "G", "F", "F", "F", "F"],
["W", "W", "W", "W", "W", "W", "W", "W", "W", "W", "W", "W", "W", "F", "W", "W", "W", "W", "W", "W", "F", "W", "W", "W", "W", "W", "W", "W", "W", "G", "G", "G", "G", "G", "G", "G", "G", "G", "G", "G", "G", "G", "G", "G", "G", "G", "F", "F", "F", "F", "F"],
["W", "W", "W", "W", "W", "W", "W", "W", "W", "W", "W", "W", "F", "F", "W", "W", "W", "W", "W", "W", "F", "F", "F", "W", "W", "W", "W", "W", "W", "W", "G", "G", "G", "G", "G", "G", "G", "G", "G", "G", "G", "G", "G", "G", "F", "F", "F", "F", "F", "F", "F"],
["W", "W", "W", "W", "W", "W", "W", "F", "W", "W", "W", "W", "W", "W", "W", "W", "W", "W", "F", "F", "F", "F", "F", "F", "W", "W", "W", "W", "W", "W", "W", "W", "G", "G", "G", "G", "G", "F", "F", "F", "F", "F", "F", "F", "F", "F", "F", "F", "F", "F", "F"],
["W", "W", "W", "W", "W", "W", "F", "F", "F", "W", "W", "W", "W", "W", "W", "W", "W", "W", "F", "F", "F", "F", "F", "F", "F", "W", "W", "W", "W", "W", "W", "W", "W", "W", "W", "F", "F", "F", "F", "F", "F", "F", "F", "F", "F", "F", "F", "F", "F", "F", "F"],
["W", "W", "W", "W", "W", "W", "F", "F", "F", "F", "W", "W", "W", "F", "F", "W", "W", "W", "W", "F", "F", "F", "F", "F", "F", "W", "W", "W", "W", "W", "W", "W", "W", "W", "W", "W", "W", "F", "F", "F", "F", "F", "F", "F", "F", "F", "F", "F", "F", "F", "F"],
["W", "W", "W", "W", "W", "F", "F", "W", "F", "F", "F", "W", "W", "F", "F", "W", "W", "W", "F", "F", "F", "F", "F", "F", "F", "F", "W", "W", "W", "W", "W", "W", "W", "W", "W", "W", "W", "W", "W", "W", "W", "W", "F", "F", "F", "F", "F", "F", "F", "F", "F"],
["W", "W", "W", "W", "W", "W", "W", "W", "W", "W", "W", "W", "W", "F", "F", "W", "W", "W", "W", "W", "F", "F", "F", "W", "F", "F", "F", "W", "W", "W", "F", "F", "W", "W", "W", "W", "W", "W", "W", "W", "W", "W", "W", "W", "W", "W", "W", "F", "F", "F", "F"],
["W", "W", "W", "W", "W", "W", "W", "W", "W", "W", "W", "F", "F", "F", "F", "F", "W", "W", "W", "F", "F", "W", "F", "F", "F", "F", "F", "W", "W", "W", "W", "F", "F", "W", "W", "W", "W", "W", "W", "W", "W", "W", "W", "W", "W", "W", "W", "W", "W", "W", "W"],
["W", "W", "W", "W", "W", "W", "W", "W", "W", "W", "W", "W", "W", "F", "F", "F", "F", "W", "W", "W", "W", "W", "W", "W", "W", "W", "F", "F", "W", "W", "W", "F", "W", "W", "W", "W", "W", "W", "W", "W", "W", "W", "W", "W", "W", "W", "W", "W", "W", "W", "W"],
["W", "W", "W", "W", "W", "W", "W", "W", "W", "W", "W", "W", "W", "W", "W", "F", "F", "W", "W", "W", "W", "W", "W", "W", "W", "W", "W", "F", "W", "W", "W", "W", "F", "F", "W", "W", "W", "W", "W", "W", "W", "W", "W", "W", "W", "W", "W", "W", "W", "W", "W"],
["W", "W", "W", "W", "W", "W", "W", "W", "W", "W", "W", "F", "F", "W", "W", "W", "W", "W", "W", "W", "W", "W", "W", "W", "W", "W", "W", "W", "W", "W", "W", "W", "W", "W", "W", "W", "W", "W", "W", "W", "W", "W", "W", "W", "W", "W", "W", "W", "W", "W", "W"],
["W", "W", "W", "W", "W", "W", "W", "W", "W", "W", "W", "W", "F", "W", "W", "W", "W", "W", "W", "W", "W", "W", "W", "W", "W", "W", "W", "W", "W", "W", "W", "W", "W", "W", "W", "W", "W", "W", "W", "W", "W", "W", "W", "W", "W", "W", "W", "W", "W", "W", "W"],
["W", "W", "W", "W", "W", "W", "W", "W", "W", "W", "W", "W", "W", "W", "W", "W", "W", "W", "W", "W", "W", "W", "W", "W", "W", "W", "W", "W", "W", "W", "W", "W", "W", "W", "W", "W", "W", "W", "W", "W", "W", "W", "W", "W", "W", "W", "W", "W", "W", "W", "W"],
["W", "W", "W", "W", "W", "W", "W", "W", "W", "W", "W", "W", "W", "W", "W", "W", "W", "W", "W", "W", "W", "W", "W", "W", "W", "W", "W", "W", "W", "W", "W", "W", "W", "W", "W", "W", "W", "W", "W", "W", "W", "W", "W", "W", "W", "W", "W", "W", "W", "W", "W"],
["W", "W", "W", "W", "W", "W", "W", "W", "W", "W", "W", "W", "W", "W", "W", "W", "W", "W", "W", "W", "W", "W", "W", "W", "W", "W", "W", "W", "W", "W", "W", "W", "W", "W", "W", "W", "W", "W", "W", "W", "W", "W", "W", "W", "W", "W", "W", "W", "W", "W", "W"],
["W", "W", "W", "W", "W", "W", "W", "W", "W", "W", "W", "W", "W", "W", "W", "W", "W", "W", "W", "W", "W", "W", "W", "W", "W", "W", "W", "W", "W", "W", "W", "W", "W", "W", "W", "W", "W", "W", "W", "W", "W", "W", "W", "W", "W", "W", "W", "W", "W", "W", "W"]
]